MMMMMMMMMMMMMMMMMMMM
MGGGGGGGGGGGGGGGGGGM
MGRGGGGGGGRGGGGGRGGM
MGGGGGGGGGGGGGGGGGGM
MGGGGGGGGGGGGGGGGGGM
MGGGGGWWGGGGGGGGGGGM
MGRGGWWWWGGGRGGRGGGM
MGGGGWWWWGGGGGGGGGGM
MGGGGGWWGGGGGGGGRGGM
MGGGGGGGGGGGGGGGGGGM
MGGGGGGGGGRGGGGGGGGM
MGGRGGGGGGGGGGGGGGGM
MGGGGGGGGGWWWGGGGGGM
MGGGGRGGGWWWWWGGGGGM
MGGGGGGGGWWWWWGGGGGM
MGGGGGGGGGWWWGGGGGGM
MGGGGRGGGGGGGGGGGRGM
MGGGGGGGGGGGGGRGGGGM
MGGGGGGGGGGGGGGGGGGM
MMMMMMMMMMMMMMMMMMMM
