MMMMMMMMMMMMMMMMMMMM
MGGGGGGGGGGGGGGGGGGM
MGGGGGGGGGGGGGGGGGGM
MGGGGGGGGGGGGGGGGGGM
MGGGGGGGGGGGGGGGGGGM
MGGGGGWWGGGGGGGGGGGM
MGGGGWRWWGGGGGGGGGGM
MGGGGWWRWGGGGGGGGGGM
MGGGGGWWGGGGGGGGGGGM
MGGGGGGGGGGGGGGGGGGM
MGGGGGGGGGGGGGGGGGGM
MGGGGGGGGGGGGGGGGGGM
MGGGGGGGGGWWWGGGGGGM
MGGGGGGGGWWRWWGGGGGM
MGGGGGGGGWWRWWGGGGGM
MGGGGGGGGGWWWGGGGGGM
MGGGGGGGGGGGGGGGGGGM
MGGGGGGGGGGGGGGGGGGM
MGGGGGGGGGGGGGGGGGGM
MMMMMMMMMMMMMMMMMMMM
